Unusual and Difficult Latin Words and Phrases in the Text with Meanings

ğ˜ğ˜¦ ğ˜¤ğ˜°ğ˜¶ğ˜­ğ˜¥ ğ˜´ğ˜°ğ˜­ğ˜·ğ˜¦ ğ˜®ğ˜°ğ˜´ğ˜µ ğ˜ˆğ˜ ğ˜´ğ˜¢ğ˜§ğ˜¦ğ˜µğ˜º ğ˜¢ğ˜¯ğ˜¥ ğ˜´ğ˜°ğ˜¤ğ˜ªğ˜¢ğ˜­ ğ˜ªğ˜®ğ˜±ğ˜¢ğ˜¤ğ˜µ ğ˜±ğ˜³ğ˜°ğ˜£ğ˜­ğ˜¦ğ˜®ğ˜´ ğ˜§ğ˜°ğ˜³ ğ˜µğ˜©ğ˜¦ ğ˜¤ğ˜¶ğ˜³ğ˜³ğ˜¦ğ˜¯ğ˜µ ğ˜¨ğ˜¦ğ˜¯ğ˜¦ğ˜³ğ˜¢ğ˜µğ˜ªğ˜°ğ˜¯ ğ˜°ğ˜§ ğ˜¨ğ˜¦ğ˜¯ğ˜¦ğ˜³ğ˜¢ğ˜µğ˜ªğ˜·ğ˜¦ ğ˜ˆğ˜ ğ˜ªğ˜§ ğ˜¸ğ˜¦ ğ˜³ğ˜¦ğ˜´ğ˜µğ˜³ğ˜ªğ˜¤ğ˜µğ˜¦ğ˜¥ ğ˜ªğ˜¯ğ˜±ğ˜¶ğ˜µğ˜´ ğ˜¢ğ˜¯ğ˜¥ ğ˜µğ˜¦ğ˜¹ğ˜µğ˜¶ğ˜¢ğ˜­ ğ˜°ğ˜¶ğ˜µğ˜±ğ˜¶ğ˜µğ˜´ ğ˜µğ˜° ğ˜“ğ˜¢ğ˜µğ˜ªğ˜¯. 

â€” ğ˜‘ğ˜°ğ˜´ğ˜¤ğ˜©ğ˜¢ ğ˜‰ğ˜¢ğ˜¤ğ˜©

Iustitiam spectare debent: To aim for justice

Negligunt: Neglect

Effluxerint: Have lost

Egestate: Poverty

Aequitate: Fairness

Jura: Laws

Aequitas: Fairness

Res naturales: Natural things

Protegere: Protect

Adiuvare: Help

Emendaretur: Improved

Omnia quae aguntur: Everything that is done

Tam in politicis quam in privatis: Both in politics and in private life

Sine iustitia, nihil est quod ferendum sit: Without justice, there is nothing that can be endured.

Nam: For

Nonnulli: Some

Lucrum capere possint: To gain profit

Hoc tamen est absurdum: But this is absurd

Cum divitiis effluxerint: When they have lost their wealth

A vera felicitate longe abeant: They are far from true happiness

Non solum de pecuniis est: Not only about money

De jure et aequitate: About law and fairness

Hominibus garantiunt ut se invicem tractent recte: Guarantee that people treat each other properly

Cum humanitate: With humanity

Unicuique suum tribuatur: Each is given what is due

Sed non solum de humanis rebus est iustitia: But justice is not only about human affairs

Sanctae sunt: They are sacred

Posteri deserta inveniant: Future generations will not find them deserted

Oportet igitur omnes: Therefore, it is necessary for all

Tam privati quam publici: Both private and public

Ut iustitia et aequitas in mundo servetur: To maintain justice and fairness in the world

Ne malum in dies augeatur: So that evil does not increase day by day

Si omnes bonum agere inciperent: If everyone began to do good

Profecto mundus emendaretur: Surely the world would be improved.

ChatGPT Jan 9 Version. Free Research Preview. Our goal is to make AI systems more natural and safe to interact with. Your feedback will help us improve